###################
#   #  ####  ######
# ####  ##  #######
#   #  ##  ########
### # ##  #########
#        ##########
###################